"a" = (/turf/closed/wall/rust,/area/shuttle/escape)
"b" = (/obj/docking_port/mobile/emergency{height = 5; id = "emergency home"; name = "BoxStation emergency evac bay"; width = 33},/turf/closed/wall/rust,/area/shuttle/escape)
"c" = (/obj/structure/simple_door/bunker,/obj/effect/decal/cleanable/dirt,/turf/open/floor/plasteel/f13{icon_state = "floorgrime"},/area/shuttle/escape)
"d" = (/obj/structure/table/reinforced,/obj/machinery/computer/terminal{dir = 8; termtag = "Secret"},/turf/open/floor/plasteel/f13{icon_state = "floorgrime"},/area/shuttle/escape)
"e" = (/obj/structure/chair/booth{dir = 8},/turf/open/floor/plasteel/grimy,/area/shuttle/escape)
"h" = (/obj/structure/chair/wood/fancy{dir = 8},/turf/open/floor/plasteel/grimy,/area/shuttle/escape)
"i" = (/obj/structure/table/wood/poker,/obj/item/toy/cards/deck,/turf/open/floor/plasteel/grimy,/area/shuttle/escape)
"j" = (/obj/effect/spawner/structure/window,/turf/open/floor/plasteel/f13{icon_state = "floorgrime"},/area/shuttle/escape)
"k" = (/obj/effect/decal/cleanable/dirt,/turf/open/floor/plasteel/f13{icon_state = "floorgrime"},/area/shuttle/escape)
"l" = (/turf/open/floor/plasteel/f13{icon_state = "floorgrime"},/area/shuttle/escape)
"m" = (/obj/structure/table/reinforced,/obj/effect/decal/cleanable/dirt,/obj/item/reagent_containers/pill/patch/jet,/turf/open/floor/plasteel/f13{icon_state = "floorgrime"},/area/shuttle/escape)
"n" = (/obj/structure/chair/booth{dir = 4},/obj/effect/decal/cleanable/dirt,/obj/effect/decal/cleanable/dirt,/turf/open/floor/plasteel/f13{icon_state = "floorgrime"},/area/shuttle/escape)
"o" = (/obj/structure/table/wood/fancy,/turf/open/floor/plasteel/grimy,/area/shuttle/escape)
"p" = (/obj/effect/decal/cleanable/dirt,/obj/effect/decal/cleanable/dirt,/turf/open/floor/plasteel/f13{icon_state = "floorgrime"},/area/shuttle/escape)
"r" = (/obj/structure/chair/booth{dir = 4},/turf/open/floor/plasteel/f13{icon_state = "floorgrime"},/area/shuttle/escape)
"s" = (/obj/machinery/smartfridge/bottlerack,/turf/open/floor/plasteel/floorgrime,/area/shuttle/escape)
"t" = (/obj/effect/decal/cleanable/dirt,/obj/effect/decal/cleanable/dirt,/obj/effect/spawner/lootdrop/trash,/turf/open/floor/plasteel/f13{icon_state = "floorgrime"},/area/shuttle/escape)
"v" = (/obj/structure/closet/fridge/meat,/turf/open/floor/plasteel/floorgrime,/area/shuttle/escape)
"w" = (/obj/structure/simple_door/metal/barred,/obj/structure/curtain{color = "#5c131b"},/obj/effect/decal/cleanable/dirt,/obj/effect/decal/cleanable/dirt,/turf/open/floor/plasteel/f13{icon_state = "floorgrime"},/area/shuttle/escape)
"x" = (/obj/structure/chair/booth{dir = 4},/obj/effect/spawner/lootdrop/trash,/turf/open/floor/plasteel/f13{icon_state = "floorgrime"},/area/shuttle/escape)
"y" = (/obj/structure/chair/booth{dir = 8},/obj/effect/decal/cleanable/dirt,/obj/effect/decal/cleanable/dirt,/turf/open/floor/plasteel/f13{icon_state = "floorgrime"},/area/shuttle/escape)
"z" = (/obj/structure/closet/locker,/obj/item/clothing/suit/toggle/chef,/obj/item/clothing/head/chefhat,/turf/open/floor/plasteel/floorgrime,/area/shuttle/escape)
"B" = (/obj/structure/curtain{color = "#5c131b"},/obj/machinery/door/airlock/centcom,/turf/open/floor/plasteel/f13{icon_state = "floorgrime"},/area/shuttle/escape)
"C" = (/obj/structure/chair/wood/fancy{dir = 4},/turf/open/floor/plasteel/grimy,/area/shuttle/escape)
"D" = (/obj/effect/decal/cleanable/dirt,/obj/effect/decal/cleanable/dirt,/obj/effect/decal/cleanable/dirt,/obj/effect/spawner/lootdrop/trash,/turf/open/floor/plasteel/f13{icon_state = "floorgrime"},/area/shuttle/escape)
"E" = (/obj/structure/table/reinforced,/obj/effect/decal/cleanable/dirt,/obj/effect/decal/cleanable/dirt,/turf/open/floor/plasteel/f13{icon_state = "floorgrime"},/area/shuttle/escape)
"F" = (/obj/structure/barricade/bars,/obj/structure/curtain{color = "#5c131b"},/obj/effect/decal/cleanable/dirt,/obj/effect/decal/cleanable/dirt,/turf/open/floor/plasteel/f13{icon_state = "plating"},/area/shuttle/escape)
"G" = (/obj/machinery/microwave/stove,/turf/open/floor/plasteel/floorgrime,/area/shuttle/escape)
"I" = (/obj/structure/curtain{color = "#5c131b"},/turf/open/floor/plasteel/floorgrime,/area/shuttle/escape)
"K" = (/obj/structure/chair/booth{dir = 4},/turf/open/floor/plasteel/grimy,/area/shuttle/escape)
"L" = (/obj/structure/table/reinforced,/obj/item/gun/ballistic/automatic/hobo/zipgun,/obj/item/ammo_box/magazine/zipgun,/turf/open/floor/plasteel/f13{icon_state = "floorgrime"},/area/shuttle/escape)
"M" = (/obj/structure/closet/crate/bin,/turf/open/floor/plasteel/grimy,/area/shuttle/escape)
"N" = (/obj/effect/decal/cleanable/dirt,/turf/closed/wall/rust,/area/shuttle/escape)
"O" = (/turf/open/floor/plasteel/floorgrime,/area/shuttle/escape)
"P" = (/obj/structure/table/reinforced,/obj/item/kitchen/knife/butcher,/turf/open/floor/plasteel/floorgrime,/area/shuttle/escape)
"Q" = (/obj/structure/chair/booth{dir = 4},/obj/effect/decal/cleanable/dirt,/turf/open/floor/plasteel/f13{icon_state = "floorgrime"},/area/shuttle/escape)
"R" = (/obj/structure/chair/booth{dir = 8},/obj/effect/decal/cleanable/dirt,/turf/open/floor/plasteel/f13{icon_state = "floorgrime"},/area/shuttle/escape)
"T" = (/obj/structure/simple_door/bunker,/turf/open/floor/plasteel/f13{icon_state = "floorgrime"},/area/shuttle/escape)
"U" = (/turf/open/floor/plasteel/grimy,/area/shuttle/escape)
"V" = (/obj/structure/barricade/bars,/obj/structure/curtain{color = "#5c131b"},/obj/effect/decal/cleanable/dirt,/turf/open/floor/plasteel/f13{icon_state = "plating"},/area/shuttle/escape)
"W" = (/obj/structure/simple_door/metal/barred,/obj/structure/curtain{color = "#5c131b"},/obj/effect/decal/cleanable/dirt,/obj/effect/decal/cleanable/dirt,/obj/effect/decal/cleanable/dirt,/turf/open/floor/plasteel/f13{icon_state = "floorgrime"},/area/shuttle/escape)
"X" = (/obj/effect/decal/cleanable/dirt,/obj/effect/decal/cleanable/dirt,/obj/effect/decal/cleanable/dirt,/turf/open/floor/plasteel/f13{icon_state = "floorgrime"},/area/shuttle/escape)
"Z" = (/obj/structure/chair/comfy/shuttle{dir = 4},/turf/open/floor/plasteel/f13{icon_state = "floorgrime"},/area/shuttle/escape)

(1,1,1) = {"
bacaaaaaTaaaaTaaaaaaaaaaaaaaaaaaa
aQknnFnmkxEyFpnnraKoeUKoeasGOTlLj
atppkwpXDpXXWXXDkBUUUUUUUIOOOaZdj
anpQxVQEpnERVtnnQaMUUCihUavPzaZdj
aacaaaaaTaaaaTNaaaaTaaaaaaaaaaaaa
"}
