"a" = (/turf/closed/wall/rust,/area/shuttle/escape)
"b" = (/obj/docking_port/mobile/emergency{height = 5; id = "emergency home"; name = "BoxStation emergency evac bay"; width = 33},/turf/closed/wall/rust,/area/shuttle/escape)
"c" = (/obj/structure/simple_door/bunker,/obj/effect/decal/cleanable/dirt,/turf/open/floor/plasteel/f13{icon_state = "floorgrime"},/area/shuttle/escape)
"d" = (/obj/structure/table/reinforced,/obj/machinery/computer/terminal{dir = 8; termtag = "Secret"},/turf/open/floor/plasteel/f13{icon_state = "floorgrime"},/area/shuttle/escape)
"e" = (/obj/structure/chair/booth{dir = 8},/turf/open/floor/plasteel/grimy,/area/shuttle/escape)
"f" = (/obj/machinery/light{dir = 1},/turf/open/floor/plasteel/grimy,/area/shuttle/escape)
"h" = (/obj/structure/chair/wood/fancy{dir = 8},/turf/open/floor/plasteel/grimy,/area/shuttle/escape)
"i" = (/obj/structure/table/wood/poker,/obj/item/toy/cards/deck,/turf/open/floor/plasteel/grimy,/area/shuttle/escape)
"j" = (/obj/effect/spawner/structure/window,/turf/open/floor/plasteel/f13{icon_state = "floorgrime"},/area/shuttle/escape)
"k" = (/obj/effect/decal/cleanable/dirt,/turf/open/floor/plasteel/f13{icon_state = "floorgrime"},/area/shuttle/escape)
"l" = (/turf/open/floor/plasteel/f13{icon_state = "floorgrime"},/area/shuttle/escape)
"m" = (/obj/structure/table/reinforced,/obj/effect/decal/cleanable/dirt,/obj/item/reagent_containers/pill/patch/jet,/turf/open/floor/plasteel/f13{icon_state = "floorgrime"},/area/shuttle/escape)
"n" = (/obj/structure/chair/booth{dir = 4},/obj/effect/decal/cleanable/dirt,/obj/effect/decal/cleanable/dirt,/turf/open/floor/plasteel/f13{icon_state = "floorgrime"},/area/shuttle/escape)
"o" = (/obj/structure/table/wood/fancy,/turf/open/floor/plasteel/grimy,/area/shuttle/escape)
"p" = (/obj/effect/decal/cleanable/dirt,/obj/effect/decal/cleanable/dirt,/turf/open/floor/plasteel/f13{icon_state = "floorgrime"},/area/shuttle/escape)
"q" = (/obj/effect/decal/cleanable/dirt,/obj/effect/decal/cleanable/dirt,/obj/effect/spawner/lootdrop/trash,/obj/machinery/light{dir = 8},/turf/open/floor/plasteel/f13{icon_state = "floorgrime"},/area/shuttle/escape)
"r" = (/obj/structure/chair/booth{dir = 4},/turf/open/floor/plasteel/f13{icon_state = "floorgrime"},/area/shuttle/escape)
"s" = (/obj/machinery/smartfridge/bottlerack,/turf/open/floor/plasteel/floorgrime,/area/shuttle/escape)
"t" = (/obj/effect/decal/cleanable/dirt,/obj/effect/decal/cleanable/dirt,/obj/effect/spawner/lootdrop/trash,/turf/open/floor/plasteel/f13{icon_state = "floorgrime"},/area/shuttle/escape)
"v" = (/obj/structure/closet/fridge/meat,/obj/effect/spawner/lootdrop/f13/foodspawner,/obj/effect/spawner/lootdrop/f13/foodspawner,/obj/effect/spawner/lootdrop/f13/foodspawner,/turf/open/floor/plasteel/floorgrime,/area/shuttle/escape)
"w" = (/obj/structure/simple_door/metal/barred,/obj/structure/curtain{color = "#5c131b"},/obj/effect/decal/cleanable/dirt,/obj/effect/decal/cleanable/dirt,/turf/open/floor/plasteel/f13{icon_state = "floorgrime"},/area/shuttle/escape)
"x" = (/obj/structure/chair/booth{dir = 4},/obj/effect/spawner/lootdrop/trash,/turf/open/floor/plasteel/f13{icon_state = "floorgrime"},/area/shuttle/escape)
"y" = (/obj/structure/chair/booth{dir = 8},/obj/effect/decal/cleanable/dirt,/obj/effect/decal/cleanable/dirt,/obj/machinery/light{dir = 1; light_color = "#706891"},/turf/open/floor/plasteel/f13{icon_state = "floorgrime"},/area/shuttle/escape)
"z" = (/obj/structure/closet/locker,/obj/item/clothing/suit/toggle/chef,/obj/item/clothing/head/chefhat,/obj/item/storage/box/drinkingglasses,/turf/open/floor/plasteel/floorgrime,/area/shuttle/escape)
"A" = (/obj/structure/chair/booth{dir = 4},/obj/effect/decal/cleanable/dirt,/obj/machinery/light{dir = 4},/turf/open/floor/plasteel/f13{icon_state = "floorgrime"},/area/shuttle/escape)
"B" = (/obj/structure/curtain{color = "#5c131b"; req_access_txt = "136"},/obj/machinery/door/airlock/centcom{req_access_txt = "136"},/turf/open/floor/plasteel/f13{icon_state = "floorgrime"},/area/shuttle/escape)
"C" = (/obj/structure/chair/wood/fancy{dir = 4},/turf/open/floor/plasteel/grimy,/area/shuttle/escape)
"D" = (/obj/effect/decal/cleanable/dirt,/obj/effect/decal/cleanable/dirt,/obj/effect/decal/cleanable/dirt,/obj/effect/spawner/lootdrop/trash,/turf/open/floor/plasteel/f13{icon_state = "floorgrime"},/area/shuttle/escape)
"E" = (/obj/structure/table/reinforced,/obj/effect/decal/cleanable/dirt,/obj/effect/decal/cleanable/dirt,/turf/open/floor/plasteel/f13{icon_state = "floorgrime"},/area/shuttle/escape)
"F" = (/obj/structure/barricade/bars,/obj/structure/curtain{color = "#5c131b"},/obj/effect/decal/cleanable/dirt,/obj/effect/decal/cleanable/dirt,/turf/open/floor/plasteel/f13{icon_state = "plating"},/area/shuttle/escape)
"G" = (/obj/machinery/microwave/stove,/turf/open/floor/plasteel/floorgrime,/area/shuttle/escape)
"H" = (/obj/structure/simple_door/bunker{req_access_txt = "136"},/turf/open/floor/plasteel/f13{icon_state = "floorgrime"},/area/shuttle/escape)
"I" = (/obj/structure/curtain{color = "#5c131b"},/turf/open/floor/plasteel/floorgrime,/area/shuttle/escape)
"K" = (/obj/structure/chair/booth{dir = 4},/turf/open/floor/plasteel/grimy,/area/shuttle/escape)
"L" = (/obj/structure/table/reinforced,/obj/item/gun/ballistic/automatic/hobo/zipgun,/obj/item/ammo_box/magazine/zipgun,/obj/machinery/light/small{dir = 1},/turf/open/floor/plasteel/f13{icon_state = "floorgrime"},/area/shuttle/escape)
"M" = (/obj/structure/closet/crate/bin,/turf/open/floor/plasteel/grimy,/area/shuttle/escape)
"N" = (/obj/effect/decal/cleanable/dirt,/turf/closed/wall/rust,/area/shuttle/escape)
"O" = (/turf/open/floor/plasteel/floorgrime,/area/shuttle/escape)
"P" = (/obj/structure/table/reinforced,/obj/item/kitchen/knife/butcher,/obj/item/reagent_containers/food/drinks/bottle/trappist,/turf/open/floor/plasteel/floorgrime,/area/shuttle/escape)
"Q" = (/obj/structure/chair/booth{dir = 4},/obj/effect/decal/cleanable/dirt,/turf/open/floor/plasteel/f13{icon_state = "floorgrime"},/area/shuttle/escape)
"R" = (/obj/structure/chair/booth{dir = 8},/obj/effect/decal/cleanable/dirt,/turf/open/floor/plasteel/f13{icon_state = "floorgrime"},/area/shuttle/escape)
"S" = (/obj/structure/chair/booth{dir = 4},/obj/effect/decal/cleanable/dirt,/obj/machinery/light,/turf/open/floor/plasteel/f13{icon_state = "floorgrime"},/area/shuttle/escape)
"T" = (/obj/structure/simple_door/bunker,/turf/open/floor/plasteel/f13{icon_state = "floorgrime"},/area/shuttle/escape)
"U" = (/turf/open/floor/plasteel/grimy,/area/shuttle/escape)
"V" = (/obj/structure/barricade/bars,/obj/structure/curtain{color = "#5c131b"},/obj/effect/decal/cleanable/dirt,/turf/open/floor/plasteel/f13{icon_state = "plating"},/area/shuttle/escape)
"W" = (/obj/structure/simple_door/metal/barred,/obj/structure/curtain{color = "#5c131b"},/obj/effect/decal/cleanable/dirt,/obj/effect/decal/cleanable/dirt,/obj/effect/decal/cleanable/dirt,/turf/open/floor/plasteel/f13{icon_state = "floorgrime"},/area/shuttle/escape)
"X" = (/obj/effect/decal/cleanable/dirt,/obj/effect/decal/cleanable/dirt,/obj/effect/decal/cleanable/dirt,/turf/open/floor/plasteel/f13{icon_state = "floorgrime"},/area/shuttle/escape)
"Y" = (/obj/machinery/light/small{dir = 1},/turf/open/floor/plasteel/floorgrime,/area/shuttle/escape)
"Z" = (/obj/structure/chair/comfy/shuttle{dir = 4},/turf/open/floor/plasteel/f13{icon_state = "floorgrime"},/area/shuttle/escape)

(1,1,1) = {"
bacaaaaaTaaaaTaaaaaaaaaaaaaaaaaaa
aQknnFnmkxEyFpnnraKoefKoeasGYHlLj
aqppkwpXDpXXWXXDkBUUUUUUUIOOOaZdj
anpQxVSEpnERVtnnAaMUUCihUavPzaZdj
aacaaaaaTaaaaTNaaaaHaaaaaaaaaaaaa
"}
